SO ./images/metal.xpm
NO ./images/brique.xpm
EA ./images/pierre1.xpm
WE ./images/bluewall.xpm

F 123,12,146
C 150,150,150

        1111111111111111111111111
        1000000000110000000000001
        1011000001110000000000001
        1001000000000000000000001
111111111011000001110000000000001
100000000011000111110111111111111
1111000000000011 100000010001
1111000000000001 101010010001
11000000000000011100000010001
10000000000000001100000010001
1E000000000000001101010010001
1100000111010101111101111000111
11110111 1110101 101111010001
11111111 1111111 111111111111