NO ./images/imagetest.xpm
SO ./images/imagetest.xpm
EA ./images/imagetest.xpm
WE ./images/imagetest.xpm

F 255,2,112
C 225,123,2

        1111111111111111111111111
        1000000000110000000000001
        1011000001110000000000001
        1001000000000000000000001
111111111011000001110000000000001
100000000011000111110111111111111
1111011111111111 100000010001
1111011111111101 101010010001
11000000110101111100000010001
10000000000000001100000010001
10000000000000001101010010001
11000001110101011111011110N0111
11110111 1110101 101111010001
11111111 1111111 111111111111